//####///
###  ####
#     $ #
# #  #$ #
# . .#@ #
#########